XXXXSXXX
X   2  X
X XXXX X
X  1   X
XXXOOXXX