XXXXSXXX
X      X
X XXXX X
X  1   X
XXXOOXXX