XXXPPXXX
X8 2 7 X
D4XXXX3S
X5 1 6 X
XXXTTXXX