XXXPPXXX
X  2   X
D4XXXX3S
X  1   X
XXXTTXXX