XXXPPXXX
X  2   X
D XXXX3S
X  1   X
XXXTTXXX