XXXPPXXX
X  2   X
D XXXX S
X  1   X
XXXTTXXX