XXXPPXXX
X      X
D XXXX S
X  1   X
XXXTTXXX